01300000011100200000133323323322123333313313320310
01300000011100200300133323323322123333313313320310
01300000011100200000133323323322123333310313320310
01300000011100000300133323323322123333313313023313
01300000011020000000133323323322123333313313300313
01310000111100000000133323323322123322313313313313
01310000111100000003133323323322122322313313310310
01310000111100000300133323323322122322313313313313
01300000111100000000133323323322122333313313320313
01310000111100200001133323323322122322313313310313
01300000011100200300133323323322123333313310310313
01300000111100200000133323323322122333313313320311
01310000111100000000133323323322122322323313313313
01310000111100000300133323323322122322313313313311
01310000111100000001133323323322122322313313313313
01310000111100000000133323323322122323313313313311
01300000011100000300133323323322123333313313010311
01300000011100200000133323323322123333313313023310
01310000011100000301133323323322122322313313313313
01310000111100000000133323323322123322313313310311
01300000011100200000133323323322122333313310310313
01300100011100200300133323323322123333313313300313
01310000011100000300133323323322122323313313313313
01300000111100200000133323323322122333313313010310
01300000011100200100133323323322123333313310300313
01310000111100000031133323323322122322313313310313
01310000011100000001133323323322122322313313333313
01310000111100000003133323323322122322313313310311
01310000111100200000133323323322122322323313310310
01300000111100200000133323323322123333313313010310
00020000010102200000123123323123123323313313113311
01310000111100000301133323323322122322313313313313
01310000111100000003133323323322122322313313313313
01300000011100200000133323323322122333313313010313
01310000111100000000133323323322122312313313313313
01300100111100200100133323323322122333313313010313
01300000011100200300133323323322123333310313010310
01300000111100000000133323323322122333313313010310
01310000111100000003133323323322122322313313310313
01300000011100200030133323323322123333313313010313
01310000111100000000133323323322122323313313333313
00020000010002200000123123323123123323313313303311
01310000111100000300133323323322123322313313313311
01300000111100300300133323323322123333313313320310
01300000011100200000133323323322123333310313010313
01300000011100200000133323323322122333313313010311
01310000011100000000133323323322222323323313313313
01310000111020000000133323323322122323313313313313
01300000111100200000133323323322122333313313010313
00020000010002200000123123323123123323313313313311
01300000011100200100133323323322123333313313002313
01300000011100200330133323323322123333313313320313
01310000111100000000133323323222222322313313313313
01300000111100200000133323323322123333313313322313
01300000011100200000133323323322123333313313023313
01300000011100200000133323323322123333323313010313
01310000011100200000133323323322123322313313310310
01300100011100200030133323323322123333313313300310
01300000111100200130133323323322123333313313010311
01310000111100000001133323323322122322323313313313
01300000011100200000133323323322123333313313223312
01310000011100000000133323323322122323323313213313
01300000011100200000133323323322122333323313320313
01300100011100200300133323323322123333313310010313
01300000111100200100133323323322122333313313000310
01300000011100200300133323323322123333323313010310
01300000111100300100133323323322123333313313311313
01300000011100200000133323323322123333313310010313
00020000010102200000123123323123123323313313133311
01300000011100300300133323323322123333323313023313
00020000000002200000123123323123123323323313123313
01310000111100000000133323323322123322313313303313
01310000111100000300133323323322122323313313323313
01300000111100200300133323323322123333313313300313
01300000111100200000133323323322122333313313023311
01310000111100000003133323323322123322313313313311
00020000010102200000123123323123123323313313123311
01300000011100000300133323323322123333323313010313
01300100011100200000133323323322123333323313300313
01300000111100200000133323323322123333313310320313
01300000011100300300133323323322123333313313300313
01300000011100200031133323323322123333313313320310
01300000111100000300133323323322123333313313300313
01310000111100000010133323323322123322313313313313
01300000111100200300133323323322122333313313320310
01300000011100200000133323323322123333311313320311
01300000111100200300133323323322123333313310310311
01300000111100200300133323323322123333313313010310
01310000111100000000133323323322122323313313300313
01310000011100200000133323323322123322313313313313
01300000011100200300133323323322123333313313030313
01310100011100000100133323323322222323313313300313
01300000111100200000133323323322122333313313300313
01300000111100200100133323323322123333313313003310
01300000111100200000133323323322123333311313320313
01310000111100000033133323323322122322313313310313
01310000111100000000133323323322122323312313313313
01300100011100200000133323323322123333310313010313
01310000111100000000133323323322222333313313313313
01310000011100000000133323323322222323323313303310
01300000011100200000133323323322122333313310010313
01300100011100200300133323323322123333313313000313
01300000011100200300133323323322123333313310300313
01300000011100200300133323323322123333323313300310
01310000111100200001133323323322122322323313313310
01300000011100200000133323323322122333323313010311
01310000011100000000131323323322222323323313313313
00020000010102200000123123323123123323313313103310
01310000011100000000133323323322222323323313303313
01300100011100200300133323323322123333313313020313
01300000011100200030133323323322123333313313000310
01300000011100000300133323323322123333313310003310
01310000111100000000133323323222222322313313310313
01310000011100200000133323323322123322313313300313
01310000111100300003133323323322122322313313310313
01300000011100200300133323323322123333313313003310
01300000011100200300133323323322122333313310010310
01300000011100000300133323323322123333320313010313
00020000010102200000123123323123123323313313303311
01310000011100200000133323323322122323323313303313
01300000011100200000133323323322123333320313010313
01310000111100000033133323323322122322323313313313
01300000011100200300133323323322123333310313023313
01300000011100200300133323323322123333323313220310
01300000011100200330133323323322123333313313110313
00020000010102200000123123123123123323113313313311
01300000011100200300133323323322123333323313023310
01300000011100200000133323323322122333323313322313
01310100111100000000133323323322222323313313312313
00020000010102200000123123123123123323323313313311
01300000011100200000133323323322122333313310010310
01310000011100000300133323323322122323313313303313
01310000111100000003133323323322122322323313313311
01310000111100200001133323323322122322313313310323
01310000111100200001133323323322122322323313310311
01310001111100200003133323323322122322313313313310
01300000111100200000133323323322123333313313003313
01300000011100200300133323323322122333313313300313
01310000111100200000133323323322123322313313300313
01300000111100200000133323323322123333310313010313
01310000111100200101133323323332222322313313000313
01300000011100200300133323323322123333323313023313
01300000011120000100133323323322123333323313023313
01300000011100200300133323323322123333310313000313
00020000010102200000123123323123123323323313313311
01300000111100200300133323323322123333310313010313
01300000111100200000133323323322122333323313220310
00020000010102200000123123323123123323313313313311
01300000111020200000133323323322123333323313320313
01310000111100200031133323323322122322313313310313
01310000111100000003133323323322122322323313113313
01310000111100200000133323323322123322313313113313
01300000011100200300133323323322123333320313010310
00020000010102200000123123123123123323313313303311
00020000010102000000123123123123123323313313133311
01300100011120200000133323323322123333310313010313
01300100011100200000133323323322123333313313000313
01300000111100200100133323323322123333310313000313
01310000111100000000133323323222322322313313313313
01310000001100200000133323323322123322313313313313
01300000011100200000133323323322123333323310320310
01300000111100200300133323323322123333313313010313
01300000011100300300133323323322123333310313020313
01310000111100000000133323323322222323323313313313
01300000011100200000133323323322122333323313023313
01300000011120000100133323323322123333311313320313
01310000011100000000133323323222222322313313313313
01300000111120000300133323323322123333313313023313
01310000111000200001133323323322122323313313313313
01300000011100200000133323323322123333313310023313
01300000011100200000133323323322122333323313020313
01300000011100200300133323323322122333313313320313
01300000111100200000133323323322122333310313100310
01310000011100200000133323323322123322313313000313
00020000010002200030123123123123123323313313303311
01300000011100200000133323323322222333313313013313
01300000111100300300133323323322122333313313320311
00020000000102200000123123123123123323313313133311
01300000111100200000133323323322222333310313010313
01300000111100200300133323323322123333310313010311
00020000010102200000123123123123123323313303133311
01300000011100300000133323323322122333323313010313
01310000111100200000133323323322122312313313310311
01310000111100200000133323323322123322313313303313
01310000111100200000133323323322122323313313000313
01310000111100000300133323323322122323313313303311
01300000011100200300133323323322123333313310023313
01310000011100000300133323323322222323323313313313
01300001111100000000133323323322123333313313300313
01300000011100200000133323323322123333323313012313
01300000011100200300133323323322123333323313012310
01310000111100200000133323323322222333313313313313
01300000111100200330133323323322123333313313010310
01300100111100300000133323323322123333313313023313
01300000111100200000133323323322123333323313300310
01300000111100200000133323323322123333311313010310
01300000111100200000133323323322123333323313120313
01300000011120000000133323323322123333311313320313
00020000010102200000123123323123123323313303133311
01300000011100200000133323323322123333311313010313