00020000011102200000123123323123123323313311112311
00020000000102230003123123323123123322323313313311
00020000110102000030121123323123123323301313133310
00020000010102203001123123323123123323310313203310
00020000010120200033123123323123123323121313303311
00020000101122200033123123123123123123113310313311
00020000111000303033123123323122123323313313313311
00020000110102203330123123323123123323313303221311
01300000111100200303133323323112122332310313010313
01300000011100200333133323223122122322323313320310
01300100111120003030133323323213122322323310010310
01300001111100200033133323323222222332313313023313
01300000011100200300133323323322122333311310000313
01300000011100300333133323323322123333320313002313
01300000111120000000133323323312122333313333300311
01300000311100203031133323323322123333323310003313
01310000111100200300133323323322123322323313313313
01310000111100000000133323323322122322313313310313
01310000111100000000133323323222222323323310113313
01310000111000000033113323322322222322313310303311
01310000111100200300133323323322122322323313313313
01310000111100200300133323323322122322323313100313
01310000011100200000133323323222222322323313300323
01310000111101203010131323323322222323323313000310
03100000101000003333311121221122322322131131120130
03100000111100003333311121121112222222131130120131
03100000111100003333311121121112222222131130120130
03100000111100003333311121121112222322131130120131
03100000111100003333311121121112222222131130000130
03100000111100003333311121121112222222130131120131
03100000101000203333311121121112222322131130120131
03100000110100003333311121121112222222131130123131
03100000111100003333331121121112222212131130120130
03100000111100203333331121121112222222131130310130
01300000011100200000133323323322322323313310023323
03100000111100003333331121122112222222131130000130
01310000111100000000133323323322222322313313120310
03100000111100003333311121121112222322130131120131
03100000110100003333331121122112222222131131120131
03100000110100003333331121122112222222131130120131
03100000111100003333311121121112222322131131120131
03100000111100003333331121123112222222131130310130
03100000111100003333311121122122322323131131000130
03100000111100003333311121121112222322131131121130
03100000111100003333311121121112222222131131123130
03100000110100003333331121121122322222131130120130
03100000111100003333331121123112222212131130310130
01300000000122000300133323322322122313313313303313
01300000111100203030133323323322222323313313321310
03100000111100003333311121121112222222131130300130